NO textures/no.xpm
SO textures/so.xpm
WE textures/we.xpm
EA textures/ea.xpm

F 153,255,153
C 153,255,255


11111111
10111001
10000001
100E0011
10000001
10010101
11111111