NO textures/wolfenstein/grey_stone.xpm
SO textures/wolfenstein/purple_stone.xpm
WE textures/wolfenstein/red_brick.xpm
EA textures/wolfenstein/woods.xpm

F 18,53,25
C 153,204,255

111111111111
100W00000011
110000000001
111111111111
