NO ../files/north_texture

SO ../files/south_texture

WE ../files/west_texture

EA ../files/east_texture

F 220,100,0

C 225,30,0

     111111111  1                   1111111
    1000S00001 101                  1000001
  11100010001   1                   1111111
 10000010001     
 11111111111     1111
111              1001
101              1001
111   111111111  1111
    1000000001
  11100010001
 10000010001
 11111111111