111111111111
1         11
1       0001
1000000 0011
10S000000001
111111111111
11         1
111111111111


parcourir la map, chaine la plus longue , malloc la taille de chaque chiane a cette taille en ajoutant
des espaces a la fin de chaque ligne pour qu'elles aient toutes la même taille

matrix = (char **)malloc (sizeof(char *) * (max_line + 1));
matrix[max_line + 1] = NULL;
i = -1;
j = -1;

while (matrix[++i])
{
matrix[i] = (char *)malloc (string_max + 1);
matrix[i][string_max + 1] = '\0';
while (matrix[i][++j])
matrix[i][j] = " ";
}

i = -1;
j = -1;

while (split[++i])
{
while (split[i][++j])
matrix[i][j] = split[i][j];
}

free(split);

